30
-------------------------------------------------------------------------------------------------------------*
-*****************************************************-*****************************************************-*
-*****************************************************-*****************************************************-*
-*****************************************************-*****************************************************-*
-*****************************************************-*****************************************************-*
-*****************************************************-*****************************************************-*
-*****************************************************-*****************************************************-*
-*****************************************************-*****************************************************-*
-*****************************************************-*****************************************************-*
-*****************************************************-*****************************************************-*
-*****************************************************-*****************************************************-*
-*****************************************************-*****************************************************-*
-*****************************************************-*****************************************************-*
-*****************************************************-*****************************************************-*
-*****************************************************-*****************************************************-*
-*****************************************************-*****************************************************-*
-***********************************************************************************************************-*
-***********************************************************************************************************-*
-***********************************************************************************************************-*
-***********************************************************************************************************-*
-***********************************************************************************************************-*
-***********************************************************************************************************-*
-***********************************************************************************************************-*
-***********************************************************************************************************-*
-***********************************************************************************************************-*
-***********************************************************************************************************-*
-***********************************************************************************************************-*
-***********************************************************************************************************-*
-***********************************************************************************************************-*
-------------------------------------------------------------------------------------------------------------*